###################
#@@@ @@@@@@@@@ @@@#
#@#@#@# #@#@#@#@#@#
#@@@ @@@@@@ @@@@@@#
#@#@#@#@#@#@#@# #@#
# @@@@@@ @@@@@@@@@#
#@#@# #@#@#@# #@#@#
#@@@@@@@ @@@@@@@@@#
#@# #@#@#@#@#@#@#@#
#@@@@@@ @@@@@@@@@@#
#@#@#@#@#@#@#@#@# #
#@@ @@@@@@@ @@@@@@#
#@#@#@#@#@# #@#@#@#
#@@@@@ @@@@@@@@@@@#
###################