#################
#@@@@@@@@@@@@@@@#
#@#@#@#@#@#@#@#@#
#@@@@@@@@@@@@@@@#
#@#@#@#@#@#@#@#@#
#@@@@@@@@@@@@@@@#
#@#@#@#@#@#@#@#@#
#@@@@@@@@@@@@@@@#
#@#@#@#@#@#@#@#@#
#@@@@@@@@@@@@@@@#
#@#@#@#@#@#@#@#@#
#@@@@@@@@@@@@@@@#
#################