% Map created by kitutou (04/05/2003)
% for testing purpose
%
########################
#                      #
#                      #
#         #  #         #
#      ####  ####      #
#      #        #      #
#      ###@@@@###      #
#   ###  #@@@@#  ###   #
#   # #  #@@@@#  # #   #
#   # ####@@@@#### #   #
#  ## @@@@@@@@@@@@ ##  #
#     @@@@@  @@@@@     #
#     @@@@@  @@@@@     #
#  ## @@@@@@@@@@@@ ##  #
#   # ####@@@@#### #   #
#   # #  #@@@@#  # #   #
#   ###  #@@@@#  ###   #
#      ###@@@@###      #
#      #        #      #
#      ####  ####      #
#         #  #         #
#                      #
#                      #
########################