%
% $Id$
% First Map created by stpohle
% for testing purpose
%
###########
#@@@@#@@@@#
#@#@@@@@#@#
#@#######@#
#@#@@@@#@@#
#@@@@#@@@@#
#@#######@#
#@#@@@@@#@#
#@@@@#@@@@#
###########