###################
# @ @ @ @ @ @ @ @ #
#@#@#@#@#@#@#@#@#@#
# @ @ @ @ @ @ @ @ #
#@#@#@#@#@#@#@#@#@#
# @ @ @ @ @ @ @ @ #
#@#@#@#@#@#@#@#@#@#
# @ @ @ @ @ @ @ @ #
#@#@#@#@#@#@#@#@#@#
# @ @ @ @ @ @ @ @ #
#@#@#@#@#@#@#@#@#@#
# @ @ @ @ @ @ @ @ #
#@#@#@#@#@#@#@#@#@#
# @ @ @ @ @ @ @ @ #
###################